Team,G,W,L,WIN%,MP,FG,FGA,FG%,3P,3PA,3P%,2P,2PA,2P%,FT,FTA,FT%,ORB,DRB,TRB,AST,STL,BLK,TOV,PF,PTS
Atlanta Hawks*,82,43,39,0.524,19880,3123,6919,0.451,729,2137,0.341,2394,4782,0.501,1484,2039,0.728,844,2793,3637,1938,672,397,1294,1491,8459
Boston Celtics*,82,53,29,0.646,19755,3168,6978,0.454,985,2742,0.359,2183,4236,0.515,1536,1903,0.807,744,2698,3442,2069,617,341,1088,1686,8857
Brooklyn Nets,82,20,62,0.244,19755,3102,6987,0.444,877,2592,0.338,2225,4395,0.506,1592,2020,0.788,720,2879,3599,1756,594,387,1356,1726,8673
Charlotte Hornets,82,36,46,0.439,19830,3093,7000,0.442,824,2347,0.351,2269,4653,0.488,1591,1953,0.815,721,2853,3574,1891,571,390,942,1360,8601
Chicago Bulls*,82,41,41,0.5,19780,3169,7142,0.444,623,1830,0.34,2546,5312,0.479,1474,1848,0.798,999,2796,3795,1851,644,394,1110,1455,8435
Cleveland Cavaliers*,82,51,31,0.622,19880,3275,6963,0.47,1067,2779,0.384,2208,4184,0.528,1431,1913,0.748,767,2822,3589,1858,540,329,1122,1486,9048
Dallas Mavericks,82,33,49,0.402,19780,2968,6750,0.44,878,2473,0.355,2090,4277,0.489,1215,1516,0.801,648,2516,3164,1705,615,309,972,1567,8029
Denver Nuggets,82,40,42,0.488,19755,3377,7194,0.469,870,2365,0.368,2507,4829,0.519,1537,1986,0.774,966,2836,3802,2077,568,324,1225,1567,9161
Detroit Pistons,82,37,45,0.451,19805,3269,7282,0.449,631,1915,0.33,2638,5367,0.492,1140,1586,0.719,908,2838,3746,1731,574,310,973,1467,8309
Golden State Warriors*,82,67,15,0.817,19780,3532,7140,0.495,982,2563,0.383,2550,4577,0.557,1457,1850,0.788,771,2873,3644,2490,785,555,1211,1585,9503
Houston Rockets*,82,55,27,0.671,19780,3305,7152,0.462,1181,3306,0.357,2124,3846,0.552,1667,2177,0.766,892,2747,3639,2070,670,351,1241,1634,9458
Indiana Pacers*,82,42,40,0.512,19855,3221,6932,0.465,709,1885,0.376,2512,5047,0.498,1467,1811,0.81,742,2702,3444,1844,669,411,1128,1597,8618
Los Angeles Clippers*,82,51,31,0.622,19755,3242,6819,0.475,841,2245,0.375,2401,4574,0.525,1586,2128,0.745,740,2790,3530,1848,613,349,1064,1626,8911
Los Angeles Lakers,82,26,56,0.317,19705,3224,7164,0.45,730,2110,0.346,2494,5054,0.493,1397,1853,0.754,933,2636,3569,1716,675,320,1243,1698,8575
Memphis Grizzlies*,82,43,39,0.524,19905,2984,6854,0.435,767,2169,0.354,2217,4685,0.473,1504,1918,0.784,885,2621,3506,1744,654,343,1060,1840,8239
Miami Heat,82,41,41,0.5,19780,3202,7037,0.455,808,2213,0.365,2394,4824,0.496,1248,1768,0.706,873,2706,3579,1742,586,469,1102,1680,8460
Milwaukee Bucks*,82,42,40,0.512,19780,3182,6715,0.474,720,1946,0.37,2462,4769,0.516,1413,1839,0.768,723,2589,3312,1984,666,436,1145,1660,8497
Minnesota Timberwolves,82,31,51,0.378,19805,3235,6922,0.467,601,1724,0.349,2634,5198,0.507,1586,1986,0.799,938,2540,3478,1940,654,370,1150,1646,8657
New Orleans Pelicans,82,34,48,0.415,19905,3210,7130,0.45,768,2196,0.35,2442,4934,0.495,1368,1825,0.75,706,2879,3585,1869,638,453,1054,1490,8556
New York Knicks,82,31,51,0.378,19855,3244,7255,0.447,704,2022,0.348,2540,5233,0.485,1364,1731,0.788,982,2722,3704,1786,581,456,1139,1668,8556
Oklahoma City Thunder*,82,47,35,0.573,19805,3237,7169,0.452,692,2116,0.327,2545,5053,0.504,1575,2113,0.745,1002,2821,3823,1721,648,408,1230,1715,8741
Orlando Magic,82,29,53,0.354,19805,3139,7133,0.44,701,2139,0.328,2438,4994,0.488,1309,1753,0.747,807,2734,3541,1820,580,395,1091,1584,8288
Philadelphia 76ers,82,28,54,0.341,19830,3088,6992,0.442,831,2443,0.34,2257,4549,0.496,1393,1806,0.771,807,2706,3513,1949,692,420,1366,1793,8400
Phoenix Suns,82,24,58,0.293,19830,3270,7260,0.45,615,1854,0.332,2655,5406,0.491,1676,2159,0.776,977,2712,3689,1604,673,399,1266,2030,8831
Portland Trail Blazers*,82,41,41,0.5,19930,3243,7059,0.459,852,2272,0.375,2391,4787,0.499,1513,1940,0.78,830,2750,3580,1733,574,408,1126,1736,8851
Sacramento Kings,82,32,50,0.39,19880,3105,6735,0.461,737,1961,0.376,2368,4774,0.496,1483,1913,0.775,715,2661,3376,1844,626,325,1201,1667,8430
San Antonio Spurs*,82,61,21,0.744,19805,3222,6864,0.469,753,1927,0.391,2469,4937,0.5,1440,1806,0.797,822,2777,3599,1954,654,486,1101,1498,8637
Toronto Raptors*,82,51,31,0.622,19780,3211,6918,0.464,725,1996,0.363,2486,4922,0.505,1615,2028,0.796,871,2676,3547,1517,677,401,1041,1708,8762
Utah Jazz*,82,51,31,0.622,19755,3033,6514,0.466,791,2128,0.372,2242,4386,0.511,1401,1875,0.747,771,2774,3545,1651,550,410,1119,1545,8258
Washington Wizards*,82,49,33,0.598,19855,3388,7136,0.475,756,2030,0.372,2632,5106,0.515,1421,1812,0.784,842,2670,3512,1956,693,340,1161,1745,8953
Atlanta Hawks*,82,48,34,0.585,19830,3168,6923,0.458,815,2326,0.35,2353,4597,0.512,1282,1638,0.783,679,2772,3451,2100,747,486,1226,1570,8433
Boston Celtics*,82,48,34,0.585,19780,3216,7318,0.439,717,2142,0.335,2499,5176,0.483,1520,1929,0.788,950,2733,3683,1981,752,348,1127,1796,8669
Brooklyn Nets,82,21,61,0.256,19755,3136,6920,0.453,531,1508,0.352,2605,5412,0.481,1286,1699,0.757,863,2614,3477,1829,627,332,1212,1476,8089
Charlotte Hornets*,82,48,34,0.585,19855,3036,6922,0.439,873,2410,0.362,2163,4512,0.479,1534,1941,0.79,734,2869,3603,1778,595,438,1030,1487,8479
Chicago Bulls,82,42,40,0.512,19905,3165,7170,0.441,651,1753,0.371,2514,5417,0.464,1354,1720,0.787,907,2889,3796,1870,495,470,1141,1545,8335
Cleveland Cavaliers*,82,57,25,0.695,19855,3171,6888,0.46,880,2428,0.362,2291,4460,0.514,1333,1783,0.748,873,2777,3650,1861,551,317,1114,1666,8555
Dallas Mavericks*,82,42,40,0.512,20005,3064,6900,0.444,806,2342,0.344,2258,4558,0.495,1454,1831,0.794,751,2781,3532,1813,560,306,1047,1595,8388
Denver Nuggets,82,33,49,0.402,19830,3093,7003,0.442,656,1943,0.338,2437,5060,0.482,1513,1974,0.766,941,2718,3659,1858,609,395,1202,1723,8355
Detroit Pistons*,82,44,38,0.537,19880,3111,7087,0.439,740,2148,0.345,2371,4939,0.48,1399,2095,0.668,1021,2777,3798,1594,573,304,1110,1557,8361
Golden State Warriors*,82,73,9,0.89,19880,3489,7159,0.487,1077,2592,0.416,2412,4567,0.528,1366,1790,0.763,816,2972,3788,2373,689,498,1245,1701,9421
Houston Rockets*,82,41,41,0.5,19830,3094,6847,0.452,878,2533,0.347,2216,4314,0.514,1671,2407,0.694,930,2601,3531,1821,821,430,1307,1790,8737
Indiana Pacers*,82,45,37,0.549,19880,3142,6985,0.45,663,1889,0.351,2479,5096,0.486,1430,1872,0.764,847,2779,3626,1741,742,391,1219,1641,8377
Los Angeles Clippers*,82,53,29,0.646,19830,3141,6759,0.465,797,2190,0.364,2344,4569,0.513,1490,2152,0.692,721,2727,3448,1873,709,460,1063,1746,8569
Los Angeles Lakers,82,17,65,0.207,19730,2880,6956,0.414,639,2016,0.317,2241,4940,0.454,1583,2028,0.781,878,2645,3523,1478,593,337,1124,1662,7982
Memphis Grizzlies*,82,42,40,0.512,19830,3019,6859,0.44,504,1521,0.331,2515,5338,0.471,1584,2024,0.783,916,2497,3413,1697,724,350,1090,1783,8126
Miami Heat*,82,48,34,0.585,19830,3150,6697,0.47,498,1480,0.336,2652,5217,0.508,1406,1889,0.744,807,2811,3618,1709,553,531,1155,1502,8204
Milwaukee Bucks,82,33,49,0.402,19830,3145,6740,0.467,440,1277,0.345,2705,5463,0.495,1392,1863,0.747,858,2559,3417,1895,672,475,1247,1695,8122
Minnesota Timberwolves,82,29,53,0.354,19880,3095,6668,0.464,455,1347,0.338,2640,5321,0.496,1753,2213,0.792,821,2587,3408,1916,656,375,1231,1696,8398
New Orleans Pelicans,82,30,52,0.366,19780,3153,7040,0.448,702,1951,0.36,2451,5089,0.482,1415,1823,0.776,782,2712,3494,1818,633,342,1102,1713,8423
New York Knicks,82,32,50,0.39,19805,3022,6886,0.439,610,1762,0.346,2412,5124,0.471,1411,1753,0.805,850,2788,3638,1682,467,466,1099,1616,8065
Oklahoma City Thunder*,82,55,27,0.671,19830,3372,7082,0.476,678,1945,0.349,2694,5137,0.524,1616,2067,0.782,1071,2916,3987,1883,603,487,1305,1691,9038
Orlando Magic,82,35,47,0.427,19905,3242,7120,0.455,636,1818,0.35,2606,5302,0.492,1249,1649,0.757,843,2709,3552,1933,673,417,1155,1701,8369
Philadelphia 76ers,82,10,72,0.122,19805,2970,6887,0.431,764,2255,0.339,2206,4632,0.476,1284,1850,0.694,777,2605,3382,1765,680,495,1343,1780,7988
Phoenix Suns,82,23,59,0.28,19705,3051,7018,0.435,738,2118,0.348,2313,4900,0.472,1431,1905,0.751,943,2733,3676,1701,632,313,1410,1858,8271
Portland Trail Blazers*,82,44,38,0.537,19805,3167,7040,0.45,864,2336,0.37,2303,4704,0.49,1424,1889,0.754,948,2782,3730,1748,562,380,1200,1782,8622
Sacramento Kings,82,33,49,0.402,19805,3283,7083,0.464,660,1839,0.359,2623,5244,0.5,1514,2089,0.725,868,2760,3628,2009,733,368,1326,1676,8740
San Antonio Spurs*,82,67,15,0.817,19705,3289,6797,0.484,570,1518,0.375,2719,5279,0.515,1342,1672,0.803,770,2831,3601,2010,677,485,1071,1433,8490
Toronto Raptors*,82,56,26,0.683,19780,3006,6669,0.451,708,1915,0.37,2298,4754,0.483,1702,2190,0.777,836,2724,3560,1536,636,449,1073,1610,8422
Utah Jazz,82,40,42,0.488,19955,2957,6593,0.449,694,1956,0.355,2263,4637,0.488,1402,1885,0.744,880,2665,3545,1555,631,425,1224,1655,8010
Washington Wizards,82,41,41,0.5,19755,3238,7033,0.46,709,1983,0.358,2529,5050,0.501,1349,1849,0.73,743,2688,3431,2005,708,323,1186,1708,8534
Atlanta Hawks*,82,60,22,0.732,19730,3121,6699,0.466,818,2152,0.38,2303,4547,0.506,1349,1735,0.778,715,2611,3326,2111,744,380,1167,1457,8409
Boston Celtics*,82,40,42,0.488,19880,3193,7211,0.443,660,2021,0.327,2533,5190,0.488,1266,1678,0.754,910,2685,3595,2009,674,294,1133,1738,8312
Brooklyn Nets*,82,38,44,0.463,19930,3069,6804,0.451,541,1633,0.331,2528,5171,0.489,1359,1817,0.748,846,2627,3473,1716,576,340,1133,1579,8038
Charlotte Hornets,82,33,49,0.402,19905,2913,6932,0.42,498,1566,0.318,2415,5366,0.45,1397,1867,0.748,820,2793,3613,1654,499,448,976,1494,7721
Chicago Bulls*,82,50,32,0.61,19880,3001,6797,0.442,645,1825,0.353,2356,4972,0.474,1618,2067,0.783,959,2792,3751,1781,514,476,1145,1495,8265
Cleveland Cavaliers*,82,53,29,0.646,19780,3089,6739,0.458,826,2253,0.367,2263,4486,0.504,1453,1934,0.751,911,2612,3523,1814,603,340,1171,1510,8457
Dallas Mavericks*,82,50,32,0.61,19880,3255,7036,0.463,732,2082,0.352,2523,4954,0.509,1386,1843,0.752,858,2608,3466,1846,663,371,1062,1644,8628
Denver Nuggets,82,30,52,0.366,19880,3099,7158,0.433,660,2032,0.325,2439,5126,0.476,1462,1991,0.734,1012,2653,3665,1788,641,367,1166,1882,8320
Detroit Pistons,82,32,50,0.39,19830,3041,7038,0.432,703,2043,0.344,2338,4995,0.468,1292,1838,0.703,1051,2630,3681,1771,623,383,1099,1559,8077
Golden State Warriors*,82,67,15,0.817,19730,3410,7137,0.478,883,2217,0.398,2527,4920,0.514,1313,1709,0.768,853,2814,3667,2248,762,496,1185,1628,9016
Houston Rockets*,82,56,26,0.683,19805,3032,6832,0.444,933,2680,0.348,2099,4152,0.506,1525,2133,0.715,958,2624,3582,1820,777,407,1366,1803,8522
Indiana Pacers,82,38,44,0.463,19855,2998,6824,0.439,612,1740,0.352,2386,5084,0.469,1373,1817,0.756,856,2822,3678,1757,505,375,1147,1742,7981
Los Angeles Clippers*,82,56,26,0.683,19730,3228,6830,0.473,827,2202,0.376,2401,4628,0.519,1468,2067,0.71,784,2711,3495,2031,640,409,1012,1749,8751
Los Angeles Lakers,82,21,61,0.256,19930,3054,7020,0.435,532,1546,0.344,2522,5474,0.461,1433,1935,0.741,952,2647,3599,1715,578,366,1086,1741,8073
Memphis Grizzlies*,82,55,27,0.671,19905,3097,6763,0.458,423,1246,0.339,2674,5517,0.485,1445,1869,0.773,856,2634,3490,1777,700,347,1094,1567,8062
Miami Heat,82,37,45,0.451,19730,2885,6330,0.456,556,1659,0.335,2329,4671,0.499,1438,1940,0.741,747,2461,3208,1626,642,372,1214,1636,7764
Milwaukee Bucks*,82,41,41,0.5,19930,3083,6722,0.459,545,1500,0.363,2538,5222,0.486,1312,1734,0.757,876,2574,3450,1932,789,403,1373,1814,8023
Minnesota Timberwolves,82,16,66,0.195,19805,2986,6820,0.438,406,1223,0.332,2580,5597,0.461,1638,2110,0.776,949,2406,3355,1771,668,327,1231,1571,8016
New Orleans Pelicans*,82,45,37,0.549,19780,3108,6795,0.457,586,1583,0.37,2522,5212,0.484,1345,1790,0.751,942,2621,3563,1806,553,510,1087,1530,8147
New York Knicks,82,17,65,0.207,19855,2882,6726,0.428,560,1614,0.347,2322,5112,0.454,1211,1575,0.769,867,2443,3310,1746,575,382,1206,1768,7535
Oklahoma City Thunder,82,45,37,0.549,19830,3184,7119,0.447,632,1864,0.339,2552,5255,0.486,1524,2020,0.754,1052,2844,3896,1681,598,454,1205,1829,8524
Orlando Magic,82,25,57,0.305,19755,3076,6792,0.453,554,1598,0.347,2522,5194,0.486,1141,1565,0.729,822,2607,3429,1692,647,314,1221,1714,7847
Philadelphia 76ers,82,18,64,0.22,19805,2765,6777,0.408,692,2160,0.32,2073,4617,0.449,1320,1953,0.676,978,2536,3514,1683,789,487,1453,1778,7542
Phoenix Suns,82,39,43,0.476,19880,3178,7038,0.452,698,2048,0.341,2480,4990,0.497,1343,1767,0.76,896,2643,3539,1659,700,385,1238,1744,8397
Portland Trail Blazers*,82,51,31,0.622,19855,3175,7049,0.45,807,2231,0.362,2368,4818,0.491,1272,1589,0.801,879,2881,3760,1799,525,372,1117,1494,8429
Sacramento Kings,82,29,53,0.354,19855,3010,6617,0.455,461,1350,0.341,2549,5267,0.484,1829,2400,0.762,895,2728,3623,1667,550,324,1333,1696,8310
San Antonio Spurs*,82,55,27,0.671,19955,3208,6854,0.468,677,1847,0.367,2531,5007,0.505,1368,1754,0.78,806,2772,3578,2000,657,444,1146,1564,8461
Toronto Raptors*,82,49,33,0.598,19855,3108,6829,0.455,726,2060,0.352,2382,4769,0.499,1585,2014,0.787,881,2526,3407,1701,615,357,1057,1712,8527
Utah Jazz,82,38,44,0.463,19705,2900,6492,0.447,610,1781,0.343,2290,4711,0.486,1391,1929,0.721,988,2617,3605,1632,623,489,1256,1583,7801
Washington Wizards*,82,46,36,0.561,19955,3139,6790,0.462,497,1381,0.36,2642,5409,0.488,1305,1758,0.742,862,2801,3663,1969,601,378,1233,1707,8080
Atlanta Hawks*,82,38,44,0.463,19830,3061,6688,0.458,768,2116,0.363,2293,4572,0.502,1392,1782,0.781,713,2565,3278,2041,680,326,1251,1577,8282
Boston Celtics,82,25,57,0.305,19730,2996,6883,0.435,575,1729,0.333,2421,5154,0.47,1325,1706,0.777,980,2505,3485,1726,584,343,1261,1743,7892
Brooklyn Nets*,82,44,38,0.537,19880,2931,6391,0.459,709,1922,0.369,2222,4469,0.497,1508,2002,0.753,721,2407,3128,1714,705,311,1191,1777,8079
Charlotte Bobcats*,82,43,39,0.524,19905,2976,6730,0.442,516,1471,0.351,2460,5259,0.468,1474,2000,0.737,776,2724,3500,1778,499,421,1010,1493,7942
Chicago Bulls*,82,48,34,0.585,19930,2843,6577,0.432,508,1459,0.348,2335,5118,0.456,1486,1908,0.779,937,2683,3620,1860,594,424,1223,1565,7680
Cleveland Cavaliers,82,33,49,0.402,19930,3036,6955,0.437,584,1640,0.356,2452,5315,0.461,1398,1861,0.751,989,2629,3618,1738,579,304,1163,1640,8054
Dallas Mavericks*,82,49,33,0.598,19830,3249,6858,0.474,721,1877,0.384,2528,4981,0.508,1378,1733,0.795,840,2514,3354,1935,704,356,1110,1636,8597
Denver Nuggets,82,36,46,0.439,19755,3147,7042,0.447,702,1959,0.358,2445,5083,0.481,1563,2154,0.726,1009,2717,3726,1838,615,459,1305,1890,8559
Detroit Pistons,82,29,53,0.354,19780,3182,7124,0.447,507,1580,0.321,2675,5544,0.483,1415,2111,0.67,1196,2525,3721,1714,687,395,1193,1666,8286
Golden State Warriors*,82,51,31,0.622,19830,3236,7005,0.462,774,2037,0.38,2462,4968,0.496,1303,1731,0.753,896,2819,3715,1912,642,407,1247,1784,8549
Houston Rockets*,82,54,28,0.659,19830,3118,6603,0.472,779,2179,0.358,2339,4424,0.529,1814,2549,0.712,920,2797,3717,1755,621,461,1323,1676,8829
Indiana Pacers*,82,56,26,0.683,19780,2949,6573,0.449,550,1542,0.357,2399,5031,0.477,1485,1907,0.779,834,2831,3665,1651,550,446,1237,1675,7933
Los Angeles Clippers*,82,57,25,0.695,19755,3208,6761,0.474,693,1966,0.352,2515,4795,0.525,1741,2384,0.73,858,2668,3526,2016,703,397,1136,1767,8850
Los Angeles Lakers,82,27,55,0.329,19705,3139,6980,0.45,774,2032,0.381,2365,4948,0.478,1390,1835,0.757,745,2620,3365,2006,611,446,1239,1627,8442
Memphis Grizzlies*,82,50,32,0.61,19805,3122,6723,0.464,405,1147,0.353,2717,5576,0.487,1235,1666,0.741,950,2526,3476,1792,631,375,1124,1568,7884
Miami Heat*,82,54,28,0.659,19880,3142,6272,0.501,665,1829,0.364,2477,4443,0.558,1431,1884,0.76,627,2397,3024,1847,732,367,1212,1596,8380
Milwaukee Bucks,82,15,67,0.183,19880,2952,6737,0.438,548,1553,0.353,2404,5184,0.464,1377,1843,0.747,971,2399,3370,1760,541,403,1238,1713,7829
Minnesota Timberwolves,82,40,42,0.488,19855,3189,7175,0.444,600,1757,0.341,2589,5418,0.478,1790,2301,0.778,1024,2644,3668,1963,718,297,1142,1504,8768
New Orleans Pelicans,82,34,48,0.415,19855,3101,6761,0.459,486,1303,0.373,2615,5458,0.479,1489,1936,0.769,933,2486,3419,1745,647,523,1129,1857,8177
New York Knicks,82,37,45,0.451,19855,3027,6739,0.449,759,2038,0.372,2268,4701,0.482,1271,1670,0.761,870,2437,3307,1641,631,367,1063,1815,8084
Oklahoma City Thunder*,82,59,23,0.72,19805,3194,6782,0.471,664,1839,0.361,2530,4943,0.512,1653,2052,0.806,887,2781,3668,1794,678,501,1256,1858,8705
Orlando Magic,82,23,59,0.28,19955,3022,6784,0.445,563,1596,0.353,2459,5188,0.474,1307,1714,0.763,794,2654,3448,1726,630,350,1222,1678,7914
Philadelphia 76ers,82,19,63,0.232,19855,3108,7150,0.435,577,1847,0.312,2531,5303,0.477,1362,1918,0.71,949,2556,3505,1791,765,330,1384,1844,8155
Phoenix Suns,82,48,34,0.585,19755,3172,6845,0.463,765,2055,0.372,2407,4790,0.503,1520,2004,0.758,928,2601,3529,1563,688,374,1258,1798,8629
Portland Trail Blazers*,82,54,28,0.659,19855,3207,7134,0.45,770,2071,0.372,2437,5063,0.481,1569,1926,0.815,1022,2786,3808,1904,454,387,1125,1576,8753
Sacramento Kings,82,28,54,0.341,19830,3026,6766,0.447,491,1475,0.333,2535,5291,0.479,1698,2237,0.759,990,2656,3646,1547,587,318,1249,1849,8241
San Antonio Spurs*,82,62,20,0.756,19755,3326,6844,0.486,698,1757,0.397,2628,5087,0.517,1289,1642,0.785,762,2786,3548,2064,604,420,1180,1495,8639
Toronto Raptors*,82,48,34,0.585,19955,2992,6718,0.445,713,1917,0.372,2279,4801,0.475,1608,2055,0.782,935,2552,3487,1737,577,343,1159,1882,8305
Utah Jazz,82,25,57,0.305,19780,2951,6652,0.444,543,1577,0.344,2408,5075,0.474,1346,1803,0.747,904,2477,3381,1664,570,366,1200,1699,7791
Washington Wizards*,82,44,38,0.537,20055,3177,6920,0.459,647,1704,0.38,2530,5216,0.485,1253,1715,0.731,886,2573,3459,1909,668,377,1204,1675,8254
Atlanta Hawks*,82,44,38,0.537,19855,3084,6644,0.464,706,1901,0.371,2378,4743,0.501,1158,1619,0.715,758,2593,3351,2007,664,369,1219,1473,8032
Boston Celtics*,81,41,40,0.506,19840,3001,6459,0.465,498,1390,0.358,2503,5069,0.494,1318,1698,0.776,654,2533,3187,1843,667,365,1181,1717,7818
Brooklyn Nets*,82,49,33,0.598,19855,2942,6544,0.45,628,1760,0.357,2314,4784,0.484,1432,1958,0.731,1047,2460,3507,1668,599,391,1206,1500,7944
Charlotte Bobcats,82,21,61,0.256,19805,2823,6649,0.425,469,1399,0.335,2354,5250,0.448,1546,2060,0.75,917,2389,3306,1587,591,479,1153,1561,7661
Chicago Bulls*,82,45,37,0.549,19830,2926,6698,0.437,446,1265,0.353,2480,5433,0.456,1343,1738,0.773,1026,2514,3540,1886,588,417,1171,1617,7641
Cleveland Cavaliers,82,24,58,0.293,19730,2993,6901,0.434,547,1581,0.346,2446,5320,0.46,1380,1826,0.756,1004,2359,3363,1694,647,334,1149,1737,7913
Dallas Mavericks,82,41,41,0.5,19980,3182,6892,0.462,606,1628,0.372,2576,5264,0.489,1323,1669,0.793,767,2670,3437,1906,648,454,1144,1698,8293
Denver Nuggets*,82,57,25,0.695,19905,3339,6983,0.478,521,1518,0.343,2818,5465,0.516,1505,2148,0.701,1092,2601,3693,2002,762,533,1253,1682,8704
Detroit Pistons,82,29,53,0.354,19805,2979,6638,0.449,513,1440,0.356,2466,5198,0.474,1307,1870,0.699,991,2463,3454,1742,574,400,1241,1623,7778
Golden State Warriors*,82,47,35,0.573,19805,3130,6840,0.458,658,1632,0.403,2472,5208,0.475,1378,1744,0.79,885,2801,3686,1845,567,346,1236,1753,8296
Houston Rockets*,82,45,37,0.549,19780,3124,6782,0.461,867,2369,0.366,2257,4413,0.511,1573,2087,0.754,909,2652,3561,1902,679,359,1348,1662,8688
Indiana Pacers*,81,49,32,0.605,19590,2845,6525,0.436,555,1599,0.347,2290,4926,0.465,1429,1915,0.746,1043,2671,3714,1645,580,513,1227,1623,7674
Los Angeles Clippers*,82,56,26,0.683,19730,3160,6608,0.478,627,1752,0.358,2533,4856,0.522,1342,1888,0.711,938,2475,3413,1958,784,461,1197,1716,8289
Los Angeles Lakers*,82,45,37,0.549,19755,3041,6640,0.458,715,2015,0.355,2326,4625,0.503,1584,2289,0.692,942,2732,3674,1818,576,429,1232,1467,8381
Memphis Grizzlies*,82,56,26,0.683,19805,2964,6679,0.444,382,1107,0.345,2582,5572,0.463,1349,1746,0.773,1059,2445,3504,1715,703,436,1144,1660,7659
Miami Heat*,82,66,16,0.805,19880,3148,6348,0.496,717,1809,0.396,2431,4539,0.536,1423,1887,0.754,676,2490,3166,1890,710,441,1143,1533,8436
Milwaukee Bucks*,82,38,44,0.463,19830,3128,7197,0.435,601,1670,0.36,2527,5527,0.457,1251,1700,0.736,1068,2537,3605,1876,685,550,1156,1554,8108
Minnesota Timberwolves,82,31,51,0.378,19730,2943,6702,0.439,450,1475,0.305,2493,5227,0.477,1515,2042,0.742,973,2473,3446,1836,700,387,1214,1509,7851
New Orleans Hornets,82,27,55,0.329,19780,2955,6589,0.448,535,1474,0.363,2420,5115,0.473,1269,1636,0.776,988,2426,3414,1721,520,440,1193,1673,7714
New York Knicks*,82,54,28,0.659,19730,2996,6689,0.448,891,2371,0.376,2105,4318,0.487,1313,1729,0.759,890,2436,3326,1579,672,294,988,1650,8196
Oklahoma City Thunder*,82,60,22,0.732,19830,3126,6504,0.481,598,1588,0.377,2528,4916,0.514,1819,2196,0.828,854,2725,3579,1753,679,624,1253,1654,8669
Orlando Magic,82,20,62,0.244,19780,3093,6904,0.448,506,1537,0.329,2587,5367,0.482,1026,1359,0.755,890,2612,3502,1871,528,358,1191,1591,7718
Philadelphia 76ers,82,34,48,0.415,19755,3059,6895,0.444,518,1438,0.36,2541,5457,0.466,1004,1377,0.729,896,2493,3389,1867,609,384,1070,1505,7640
Phoenix Suns,82,25,57,0.305,19805,3061,6917,0.443,480,1455,0.33,2581,5462,0.473,1203,1618,0.744,959,2454,3413,1855,659,434,1278,1688,7805
Portland Trail Blazers,82,33,49,0.402,19855,3009,6715,0.448,673,1904,0.353,2336,4811,0.486,1304,1680,0.776,874,2474,3348,1784,538,353,1203,1518,7995
Sacramento Kings,82,28,54,0.341,19830,3086,6904,0.447,610,1681,0.363,2476,5223,0.474,1437,1869,0.769,943,2385,3328,1708,671,342,1199,1717,8219
San Antonio Spurs*,82,58,24,0.707,19880,3210,6675,0.481,663,1764,0.376,2547,4911,0.519,1365,1725,0.791,666,2721,3387,2058,695,446,1206,1427,8448
Toronto Raptors,82,34,48,0.415,19980,2979,6685,0.446,571,1665,0.343,2408,5020,0.48,1442,1831,0.788,871,2426,3297,1765,595,392,1124,1836,7971
Utah Jazz,82,43,39,0.524,19880,3046,6710,0.454,507,1385,0.366,2539,5325,0.477,1439,1883,0.764,989,2457,3446,1859,690,515,1210,1750,8038
Washington Wizards,82,29,53,0.354,19855,2910,6693,0.435,545,1495,0.365,2365,5198,0.455,1279,1746,0.733,887,2652,3539,1775,598,376,1238,1681,7644
Atlanta Hawks*,66,40,26,0.606,16165,2429,5348,0.454,492,1330,0.37,1937,4018,0.482,1025,1385,0.74,652,2066,2718,1481,536,303,921,1178,6375
Boston Celtics*,66,39,27,0.591,15940,2341,5086,0.46,363,988,0.367,1978,4098,0.483,1017,1308,0.778,509,2051,2560,1557,498,362,979,1315,6062
Charlotte Bobcats,66,7,59,0.106,15890,2193,5293,0.414,263,892,0.295,1930,4401,0.439,1090,1462,0.746,677,1894,2571,1326,397,361,957,1249,5739
Chicago Bulls*,66,50,16,0.758,15940,2467,5462,0.452,419,1117,0.375,2048,4345,0.471,1006,1394,0.722,915,2165,3080,1527,456,388,923,1139,6359
Cleveland Cavaliers,66,21,45,0.318,15965,2261,5360,0.422,440,1273,0.346,1821,4087,0.446,1178,1645,0.716,841,1949,2790,1308,466,262,1017,1317,6140
Dallas Mavericks*,66,36,30,0.545,16065,2398,5412,0.443,497,1464,0.339,1901,3948,0.482,1029,1334,0.771,665,2157,2822,1380,565,337,926,1226,6322
Denver Nuggets*,66,38,28,0.576,16040,2572,5404,0.476,435,1311,0.332,2137,4093,0.522,1293,1760,0.735,738,2105,2843,1581,540,330,1015,1297,6872
Detroit Pistons,66,25,41,0.379,15965,2291,5232,0.438,317,916,0.346,1974,4316,0.457,1098,1461,0.752,775,1882,2657,1232,460,278,1033,1293,5997
Golden State Warriors,66,23,43,0.348,15915,2489,5443,0.457,524,1351,0.388,1965,4092,0.48,951,1235,0.77,640,1947,2587,1470,528,362,915,1410,6453
Houston Rockets,66,34,32,0.515,16065,2489,5543,0.449,478,1330,0.359,2011,4213,0.477,1018,1301,0.782,769,2014,2783,1404,496,319,955,1347,6474
Indiana Pacers*,66,42,24,0.636,15990,2354,5375,0.438,392,1064,0.368,1962,4311,0.455,1349,1724,0.782,826,2070,2896,1228,523,357,925,1430,6449
Los Angeles Clippers*,66,40,26,0.606,15965,2439,5366,0.455,514,1441,0.357,1925,3925,0.49,1046,1538,0.68,800,1943,2743,1385,556,315,879,1399,6438
Los Angeles Lakers*,66,41,25,0.621,16065,2429,5319,0.457,362,1112,0.326,2067,4207,0.491,1202,1589,0.756,799,2251,3050,1485,390,351,997,1109,6422
Memphis Grizzlies*,66,41,25,0.621,15940,2425,5422,0.447,277,849,0.326,2148,4573,0.47,1142,1504,0.759,831,1944,2775,1290,631,345,955,1316,6269
Miami Heat*,66,46,20,0.697,16040,2446,5212,0.469,370,1030,0.359,2076,4182,0.496,1238,1598,0.775,686,2060,2746,1317,585,355,1002,1282,6500
Milwaukee Bucks,66,31,35,0.47,15865,2502,5652,0.443,436,1265,0.345,2066,4387,0.471,1095,1415,0.774,820,1983,2803,1550,548,335,929,1273,6535
Minnesota Timberwolves,66,26,40,0.394,15940,2355,5434,0.433,473,1423,0.332,1882,4011,0.469,1281,1662,0.771,797,2089,2886,1290,436,293,1001,1212,6464
New Jersey Nets,66,22,44,0.333,15890,2262,5320,0.425,507,1481,0.342,1755,3839,0.457,1113,1433,0.777,783,1879,2662,1311,493,260,995,1268,6144
New Orleans Hornets,66,21,45,0.318,15940,2300,5103,0.451,259,777,0.333,2041,4326,0.472,1057,1397,0.757,724,1991,2715,1368,488,316,1024,1324,5916
New York Knicks*,66,36,30,0.545,15940,2365,5335,0.443,517,1538,0.336,1848,3797,0.487,1211,1634,0.741,743,2012,2755,1328,622,276,1056,1391,6458
Oklahoma City Thunder*,66,47,19,0.712,15990,2462,5229,0.471,472,1317,0.358,1990,3912,0.509,1406,1744,0.806,726,2157,2883,1224,498,539,1079,1352,6802
Orlando Magic*,66,37,29,0.561,15965,2275,5162,0.441,670,1785,0.375,1605,3377,0.475,995,1508,0.66,742,2060,2802,1321,451,275,984,1168,6215
Philadelphia 76ers*,66,35,31,0.53,15915,2471,5516,0.448,349,963,0.362,2122,4553,0.466,889,1198,0.742,704,2144,2848,1453,526,340,738,1157,6180
Phoenix Suns,66,33,33,0.5,15840,2495,5445,0.458,444,1295,0.343,2051,4150,0.494,1058,1397,0.757,717,2035,2752,1486,431,366,928,1233,6492
Portland Trail Blazers,66,28,38,0.424,15965,2402,5417,0.443,478,1382,0.346,1924,4035,0.477,1133,1423,0.796,735,1949,2684,1349,528,322,935,1251,6415
Sacramento Kings,66,22,44,0.333,15915,2490,5712,0.436,411,1301,0.316,2079,4411,0.471,1127,1532,0.736,882,1947,2829,1271,561,323,952,1287,6518
San Antonio Spurs*,66,50,16,0.758,15940,2611,5463,0.478,552,1405,0.393,2059,4058,0.507,1067,1427,0.748,683,2153,2836,1528,490,293,895,1143,6841
Toronto Raptors,66,23,43,0.348,15965,2268,5154,0.44,365,1075,0.34,1903,4079,0.467,1085,1410,0.77,697,2074,2771,1382,429,321,1001,1532,5986
Utah Jazz*,66,36,30,0.545,16165,2523,5531,0.456,273,845,0.323,2250,4686,0.48,1258,1668,0.754,861,2055,2916,1439,545,385,936,1441,6577
Washington Wizards,66,20,46,0.303,15865,2414,5475,0.441,344,1075,0.32,2070,4400,0.47,1008,1386,0.727,775,1975,2750,1262,527,417,1008,1405,6180
Atlanta Hawks*,82,44,38,0.537,19730,2971,6429,0.462,502,1427,0.352,2469,5002,0.494,1346,1728,0.779,762,2460,3222,1802,497,341,1118,1554,7790
Boston Celtics*,82,56,26,0.683,19780,3023,6219,0.486,408,1119,0.365,2615,5100,0.513,1459,1895,0.77,639,2542,3181,1921,676,344,1195,1678,7913
Charlotte Bobcats,82,34,48,0.415,19805,2873,6365,0.451,393,1203,0.327,2480,5162,0.48,1511,1999,0.756,848,2444,3292,1728,524,433,1192,1637,7650
Chicago Bulls*,82,62,20,0.756,19830,3042,6587,0.462,511,1415,0.361,2531,5172,0.489,1492,2008,0.743,967,2654,3621,1827,592,468,1161,1639,8087
Cleveland Cavaliers,82,19,63,0.232,19755,2886,6647,0.434,509,1489,0.342,2377,5158,0.461,1546,2075,0.745,856,2449,3305,1720,544,341,1166,1648,7827
Dallas Mavericks*,82,57,25,0.695,19705,3069,6463,0.475,645,1768,0.365,2424,4695,0.516,1437,1850,0.777,780,2618,3398,1954,557,352,1145,1575,8220
Denver Nuggets*,82,50,32,0.61,19705,3145,6613,0.476,662,1704,0.388,2483,4909,0.506,1859,2429,0.765,791,2652,3443,1813,605,352,1157,1719,8811
Detroit Pistons,82,30,52,0.366,19880,3056,6647,0.46,472,1256,0.376,2584,5391,0.479,1367,1854,0.737,931,2236,3167,1730,595,328,1067,1629,7951
Golden State Warriors,82,36,46,0.439,19830,3251,7047,0.461,685,1749,0.392,2566,5298,0.484,1290,1695,0.761,955,2370,3325,1847,737,406,1198,1806,8477
Houston Rockets,82,43,39,0.524,19880,3170,6975,0.454,677,1843,0.367,2493,5132,0.486,1668,2083,0.801,962,2549,3511,1955,581,371,1110,1641,8685
Indiana Pacers*,82,37,45,0.451,19780,3003,6787,0.442,585,1653,0.354,2418,5134,0.471,1592,2035,0.782,914,2657,3571,1611,584,456,1262,1782,8183
Los Angeles Clippers,82,32,50,0.39,19855,3015,6594,0.457,513,1519,0.338,2502,5075,0.493,1546,2187,0.707,955,2501,3456,1813,585,402,1343,1733,8089
Los Angeles Lakers*,82,57,25,0.695,19830,3128,6757,0.463,524,1487,0.352,2604,5270,0.494,1541,1979,0.779,989,2616,3605,1801,602,422,1073,1555,8321
Memphis Grizzlies*,82,46,36,0.561,19880,3200,6801,0.471,309,926,0.334,2891,5875,0.492,1486,1981,0.75,970,2391,3361,1691,771,441,1145,1705,8195
Miami Heat*,82,58,24,0.707,19780,3031,6301,0.481,547,1479,0.37,2484,4822,0.515,1760,2288,0.769,790,2666,3456,1639,544,430,1142,1674,8369
Milwaukee Bucks,82,35,47,0.427,19830,2814,6544,0.43,483,1414,0.342,2331,5130,0.454,1423,1881,0.757,862,2480,3342,1545,617,399,1103,1682,7534
Minnesota Timberwolves,82,17,65,0.207,19780,3090,7014,0.441,589,1565,0.376,2501,5449,0.459,1519,1977,0.768,1085,2556,3641,1650,592,422,1398,1825,8288
New Jersey Nets,82,24,58,0.293,20005,2918,6638,0.44,459,1337,0.343,2459,5301,0.464,1427,1881,0.759,909,2440,3349,1723,458,384,1152,1807,7722
New Orleans Hornets*,82,46,36,0.561,19830,2944,6416,0.459,444,1232,0.36,2500,5184,0.482,1452,1897,0.765,824,2468,3292,1691,624,359,1069,1719,7784
New York Knicks*,82,42,40,0.512,19780,3140,6867,0.457,765,2081,0.368,2375,4786,0.496,1689,2087,0.809,847,2470,3317,1757,625,475,1123,1743,8734
Oklahoma City Thunder*,82,55,27,0.671,20005,3066,6609,0.464,487,1403,0.347,2579,5206,0.495,1977,2401,0.823,903,2604,3507,1672,654,487,1156,1836,8596
Orlando Magic*,82,52,30,0.634,19830,2956,6411,0.461,770,2103,0.366,2186,4308,0.507,1453,2101,0.692,864,2679,3543,1636,548,384,1224,1640,8135
Philadelphia 76ers*,82,41,41,0.5,19930,3125,6776,0.461,443,1248,0.355,2682,5528,0.485,1426,1851,0.77,850,2578,3428,1861,621,355,1063,1592,8119
Phoenix Suns,82,40,42,0.488,20005,3219,6844,0.47,701,1857,0.377,2518,4987,0.505,1472,1939,0.759,821,2478,3299,1945,545,357,1169,1666,8611
Portland Trail Blazers*,82,48,34,0.585,19805,2951,6599,0.447,518,1503,0.345,2433,5096,0.477,1476,1835,0.804,996,2230,3226,1736,660,358,1070,1585,7896
Sacramento Kings,82,24,58,0.293,19855,3134,6979,0.449,428,1277,0.335,2706,5702,0.475,1455,1981,0.734,1071,2526,3597,1675,608,391,1324,1805,8151
San Antonio Spurs*,82,61,21,0.744,19780,3148,6628,0.475,685,1727,0.397,2463,4901,0.503,1521,1984,0.767,829,2603,3432,1836,602,372,1101,1556,8502
Toronto Raptors,82,22,60,0.268,19780,3144,6755,0.465,345,1091,0.316,2799,5664,0.494,1491,1976,0.755,963,2343,3306,1795,581,350,1206,1807,8124
Utah Jazz,82,39,43,0.476,19880,3064,6590,0.465,435,1256,0.346,2629,5334,0.493,1590,2061,0.771,898,2338,3236,1921,629,484,1175,1865,8153
Washington Wizards,82,23,59,0.28,19930,3048,6888,0.443,392,1182,0.332,2656,5706,0.465,1489,1999,0.745,1013,2374,3387,1592,665,502,1258,1850,7977